7.ox
.....oooo.....
.....o......o.
....oo........
.o.....oo.....
....o........o
..o.......o...
......o...o...
